##########################
#                        #
#                        #                        
#                        #
#                        #
#                        #
#                        #
#                        #
##########################
